WE ./include/textures/red.png
EA ./include/textures/green.png
NO ./include/textures/blue.png
SO ./include/textures/yellow.jpg


C 91,1656,252
F 224,184,144

111111111111 1111111111111111111
100000000001 11000E00000000000001
10000000000111000000000011111111
1000000000000010100000001
1100000000000110100000001
100000000000000000000000111111
1000000000111111000000000000011111
10000000001    000000000000001
1000000000111111000000000000001
1000000000000000000000001111111
1111111111111111111111111
