WE ./include/textures/red.png
EA ./include/textures/green.png
NO ./include/textures/blue.png
SO ./include/textures/yellow.png


C 91,166,252
F 224,184,144


1111111111111111111111111111
1000000000010000000000001111
1000000000000000000000011111
1000000000000000000000001111
1100000000000000000000000001
1000000000000000000000001111
1000000000000000000010001111
100N000000000000000010001111
1111111111111111111111111111
