WE ./include/textures/red.png

NO ./include/textures/green.png

EA ./include/textures/yellow.png

SO ./include/textures/blue.png

C 45,120,190
F 90,89,53

1111111111111111111
100000000S000000001
1010000000000000101
1000000000000000001
1000000000000000001
1000000000000000001
1000000001000000001
1000000000000000001
1000000000000000001
1010000000000000101
1000000000000000001
1111111111111111111