WE ./include/textures/castle4.png

NO ./include/textures/castle4.png

EA ./include/textures/castle4.png

SO ./include/textures/castle4.png

C 45,120,190
F 90,89,    			53


1111111111111111111
1000000000000000001
1010000000000000101
100000000000S000001
1000000000000000001
1000000000000000001
1000000001000000001
1000000000000000001
1000000000000000001
1010000000000000101
1000000000000000001
1111111111111111111