WE ./include/textures/red.png

NO ./include/textures/green.png

EA ./include/textures/yellow.png

SO ./include/textures/3d.jpg

C 45,120,k56
F 90,89,    			53


1111111111111111111
1000000000000000001
1010000000000000101
100000000000S000001
1000000000000000001
10000000000000000011
 10000000010000000001
10000000000000000011
1000000000000000001
1010000000000000101
1000000000100000001
1111111111111111111