
WE ./include/textures/castle2.png


EA ./include/textures/castle2.png

NO ./include/textures/castle2.png
SO ./include/textures/castle2.png


C 0,0,0
F 0,0,0



1111111111111111
1E00000010000001
1000000010000001
1000000000000001
1000000000000001
1000000000000001
1111111111111111

