
WE ./include/textures/red.png


NO ./include/textures/green.png
EA ./include/textures/yellow.png

SO ./include/textures/blue.png


C 45,120,190
F 90,89,53



      1111
      1E01
      1111
      1
      111
      101
      111