NO ./include/textures/1.png


WE ./include/textures/1.png

EA ./include/textures/1.png




SO ./include/textures/1.png





C 172,245,253
F 38,150,36


      111111111111111111                                     1111111111     1111111111
 111111110000000000000011                                   100000000001111110000000001
 100000000000000000111001111111111111111111111111111111111111000000000000110000000000001
 1100000000001000001  10000000000000000000000000000000E000000000000000000000000000000001
 1111111111111111111  11111111111111111111111111111111111111110000000000000000000000001
                                                            10100000000000010000000001
                                                            1110000000000000000000001
                                                               1111111111111111111111
