
WE ./include/textures/red.png

EA ./include/textures/yellow.png

NO ./include/textures/green.png
SO ./include/textures/blue.png


C 150,125,20
F 15,15,60


11111
10001
10101
10N01
11111