
WE ./include/textures/red.png


EA ./include/textures/green.png

NO ./include/textures/blue.png
SO ./include/textures/green.png


C 180,92,68
F 85,96,32



1111111111111111
1E00000010000001
1000000010000001
1000000010000001
1000000000000001
1000000000000001
1111111111111111

