NO           			./textures/wall1.png 
EA  	              ./textures/wall4.png                     
WE	      		    ./textures/wall3.png                                        		     
SO              		./textures/wall2.png 			
F 128, 128, 128
C 128, 128, 128

11111111111
10000010001
1010000011
1001000001
100000001
100000001
1000000001
10000N00001
1010101001
111111111