
WE ./include/textures/castle1.png


EA ./include/textures/castle2.png

NO ./include/textures/castle2.png
SO ./include/textures/castle2.png


C 0,0,0
F 0,0,0



1111
1E01
1111