NO ./include/textures/castle1.png
EA ./include/textures/floor.png
SO ./include/textures/ceiling.png

WE ./include/textures/clouds.png


C 172,245,253
F 33,30,30


      111111111111111111
 111111110000000000000011
 1000000000000000001110011
 110000000000E000001  10011
 1111111111111111111  11111
