
WE ./include/textures/red.png


EA ./include/textures/green.png

NO ./include/textures/blue.png
SO ./include/textures/green.png


C 180,92,68
F 85,96,32



           1111111111111111111111111
           1S00000000110000000000001
           1011000001110000000000001
           1001000000000000000000001
   111111111011000001110000000000001
   100000000011000001110111111111111
   11110111111111011100000010001
   11110111111111011101010000001
   11000000110101011100000010001
   10000000000000000000000010001
   10000000000000001101010010001
   11000001110101011111011110011
   11110111 1110101 101111010001
   11111111 1111111 111111111111
