
WE ./include/textures/red.png

NO ./include/textures/green.png

EA ./include/textures/yellow.png

SO ./include/textures/blue.png

C 45,120,190
F 90,89,53

              11111111111111
111111111     10000000000001
1100000011111110100000000101
1E000000D00000D0000000000001
11000000111D1110000000000001
1111111111101110100000000101
          101110000000000001
          10111111111D111111
          100000000000000001
          11111D11111D111111
          100000011100000001
          100000001000000001
          10000000D000000001
          100000001000000001
          111111111111111111