NO           			./textures/wall1.png 
EA  	              ./textures/wall4.png                     
WE	      		    ./textures/wall3.png                                        		     
SO              		./textures/wall2.png 			
F 128, 128, 128
C 128, 128, 128

111111111111
100000100011
10100000111
10010000011
1000000011
1000000011
10000000011
10000N000011
10000000011
1111111111