NO NO.
SO SO.
EA EA.
WE WE.
C 
F 

11111111111111111111111111111111111111111111111111
10000100000000000100000000010100000000000001000101
10100100110111110010001100100010100010010101010001
10000110001000001000010001001000100100001001001011
11010000100111000000100110010000010001101010010001
10011100010000110010001000010100101000001010010101
10100001000010000100010011100010100001101000010101
10010000111100100011000000010010101010000001100101
10011100000000100100100010001010010010000010000101
10000010000001000000001001001010000010110000001001
10001001000000010111000001001011111011001001010001
11100100011101101000011101101000000100000100100101
10010010100010000010100010001111010100110100101001
10001010001000101100101010010000100101000101001001
10010000000110010000101000100110001001000101010001
10000001001001010100100100001001110010100010010111
10101010010000010011000100010000000100101000100001
11001010001010001000000000001010110001000101011001
10001000101000110001000011101001000100000010000101
10010111000101000110010100000101001111111100110011
10100000100101010000101001010100000100000001001001
10101110001000000100100001000110101001001110000101
10100000110110011000100110001000101010010000111001
10111110000000100010100001010010010010101011000001
10000001100000101000100101000011000101001000001111
10100010010000100100101001000100101000001010010001
10101000000100100101001010001000001001001010010001
10101001001000010100001010010101110010110011000101
10101000110010100011001000000100000010000000010001
10101101000010010100010101000101000000110000001001
10100010010010010010100000110010101100000001010001
10011001000101001000001010001000100001001101100011
10100101001000111101010011000110010010010000001001
10001001000100001001000000110001001001001101110001
11001010001001100010001100000100010001100010001101
10101000010010010100010010100010100100001000100001
1000111001E010001001100001001100100010010010001001
10000000000100101000000100010010001010000010001001
11111001100010100010111000100010110001011011010011
10000010001010011001000100010010000101100000010001
10011100010011000101010111000010101000000111100101
10100010001100010100010000100010100001110000000011
10010010100000010100000010000001010010000111111001
10010100101110100100111101011100001010101000000101
10100101110000010101000000100011100010100001101001
10100100100101000101001110001000010100010010000001
10100010000101101010010000010111001000101101011011
10000101000100010001011101100000100001000000000101
10000000000001000100000000000010010000000100000001
11111111111111111111111111111111111111111111111111
