WE ./include/textures/castle1+.png

EA ./include/textures/castle1+.png

NO ./include/textures/castle1+.png
SO ./include/textures/castle1+.png

C 123,90,210
F 0,0,8

1111111111
1N10101001
1000000001
1101D10101
1000000001
1D101D1D11
1000000001
1111111111
