WE ./include/textures/red.png

EA ./include/textures/blue.png

NO ./include/textures/yellow.png
SO ./include/textures/green.png
C  123,50,210
F  0,0,0

1111111111
1N10101001
1000000001
1101010101
1000000001
1010101011
1000000001
1111111111