WE ./include/textures/Untitled.png

EA ./include/textures/Untitled.png

NO ./include/textures/Untitled.png
SO ./include/textures/Untitled.png
F 50,160,81
C  190,240,220

1111111111111
1000000000001
100000S000001
1000000000001
1000000000001
1000000000001
100001D100001
1000000000001
1000000000001
1000000000001
1111111111111