WE ./include/textures/red.png

EA ./include/textures/green.png

NO ./include/textures/blue.png
SO ./include/textures/yellow.png
F 255,255,0
C  0,255,0

11111111
10000001
10010001
100D00W1
10010001
10000001
11111111