WE ./include/textures/castle1.png

EA ./include/textures/castle1.png

NO ./include/textures/castle1.png
SO ./include/textures/castle1.png
F 0,0,0
C  0,0,0

11111111
100S0001
10000001
101D1001
10000001
10000001
11111111