WE ./include/textures/castle1+.png

EA ./include/textures/castle1+.png

NO ./include/textures/castle1+.png
SO ./include/textures/castle1+.png
C  123,50,210
F  0,0,0

1111111111111
1000000000001
1S00000000001
1000000000001
1D1001D11D101
101D110100001
100001D100001
1000000000001
1000000000001
1000000000001
1111111111111