WE ./include/textures/castle1+.png

EA ./include/textures/castle1+.png

NO./include/textures/castle1+.png

SO ./include/textures/castle1+.png

C 123,90,210
F 40,20,8
                 1   1                                                          
                101110111111                                                    
                1010000000001                                                   
                1000100000001  1                                                
   1            101110000001 1101                                               
  101          1001 1000110110101        1                                      
 1001           101 10100000000001     1101                                     
10001          1001110100101111001    100011                                    
101011111     110000001000001  101     100001                                   
10101000011111011111101000001  101     10000111                                 
10100000000000000111001011001  101    10000000011111111                         
1011110011000100000000101100111101     10000000000000001                        
 1   10011000100000000000100000001111111001010000011111                         
   1 10011000000000110101 1110100000000000001001001                             
  101100000000000000001001  10101110000001001001001                             
  100001110101101110000001  10001010100000000000001                             
 10000011100011011 1101001  10000010100010001100001                             
  10110000000000001110011    1101000100000001 1111                              
  10110101111100001000001     1011101010111001                                  
  10110101    1000111101      1000000000011001                                  
  10110101    1001011101 1    10111101111 10001                                 
  101101101   1001000101101   10101 1     1001                                  
  101100101   100000000110011110101       1001                                  
  1000000011  100100000000000000001       101                                   
 110111000101 10000000000000111011        101                                   
100001000010111000010111001011101         101                                   
1000000110100010000000000000100011        101                                   
 11100N1000000000000000110111100001       1001                                  
10000000011000000110000000000001001  1  1 101                                   
100011000000000000000101111011000011101101101                                   
100000000001000001001111111011000000000000101                                   
 11000000000000001000000000000011000000000001                                   
 1100000000000000001111001000101100000010101                                    
10000000000000000001111001001100100111000101                                    
100000010000000000000001010000001001  1111011                                   
100100000010000000111101000010101101     10001                                  
100000011010010000111100001110001101      10001                                 
100000000000011000000000001 10001101      10001                                 
1000000000110110001000110001100011011      10001                                
 100000011 101100010000000000000010001111  1001                                 
 100000011111100000000010111100001001100011000111                               
 1010000000001010000001001  1000000011000000000001                              
10000000110100000000001101111000000000011110000011                              
1000000000000101110110110000000000001101  101110101                             
1000000000000000000000000000001001101 1   101 10001                             
 11000000000011101111111000011001 101    10001 111                              
1000111011101  100001  1010011101  1    110001                                  
10001  1  101 1000001  1000000001      10001111                                 
100011    101 1010001  10011101001111 1000000001                                
 100001   101 101000111101  100000000110010000011                               
 10011    1011000000000101  1010000001100100000101                              
  11       1  111011000001  1011000011100110000001                              
               10011101101  10100000000000100000001                             
              100000001101  10101110000000000000001                             
             1000111000001  1000000001100000101101                              
            110101 1001101  101111001 101110100001                              
           100011  1001101   1   101  101 101011001                             
            100111 1001101       101   1  10000001                              
            10000010001101       101       1111101                              
             11111 111  1         1             1       