
WE ./include/textures/castle1+.png

EA ./include/textures/castle1+.png

NO./include/textures/castle1+.png

SO ./include/textures/castle1+.png

C 123,90,210
F 40,20,8

         11111111                                                               
        1000000001                                                              
        100011111      1                                                        
        10001         101                                                       
         1001         101 1                                                     
         1001        1001101                                                    
         10011111111111D1101                                                    
         10000000000000011D1111                                                 
         1D111101D11111000000001                                                
        1001111010111100111110001                                               
        10000000000000001    1001                                               
       10000000000000000111111001                                               
        10110000011110100000000001                                              
        1011000001101D10100011111                                               
         1 100100100000010001                                                   
     1111111D1100100000000001                                                   
    1000000000000000000000001                                                   
    10000000000001100010000001                                                  
     100000000110000001100011                                                   
     101000000111100001 111                                                     
    1100000000000000001                                                         
   10000011110000000001 1                                                       
    100001  1011110000110111                                                    
    10001   10100010100000001                                                   
    100011111111001110011111                                                    
   100000000000000111001                                                        
   10000101101D11D1101101                          1                            
 111000011110000000010011                         10111             1           
1000001D110000010000100001                        10000111111111111101          
 1110000010000001110000111 1                      100100000000000000001         
  110000010000001 10000000101                    11D110000111111110111          
 1000000000100001111000000001                  11000100001     10001            
  100001110000000000011110001                1100000000001      1101            
  10111  10000000010111100101111            10000110000001       101            
  101 111101000N00000000000000001     111    1000000110001        1             
 1101100000001000011000000101001     10001  11000000000001  111111              
1000111100000000001100001010001 1111110001 10000100111D101110000001             
100000000111000000000010001100110000010001  11000001 10100000000001             
1000000001 10100000010100001000000000000011  100110111D100000100001             
10011000011001100001100010000101111110000001  10000000000001010001              
1000000101100000000100000000000111111010011    10011100000000000001             
100000010110101000000000000001000000000001     1001000011101111111              
 11110000000000000000010000000000000011001     1001011D11101                    
   110110000011000000000000000000000011001     10000100000001                   
  10000000001  100000000000000000100011001      11111000000011                  
   11111111D111001100001111100000000000001          10000000001                 
        10000000001D111    100000010000001          10000001101                 
         100000000101      1001000000000001        1000000011D11                
         1000000101011      100110100000001         1111000000001               
         10000111000001     100010000010101            100011111                
         10110000000001      10010111000101         1110000111                  
         1000001000001       1000000001D1D111111111100000100001                 
         10000000010011     100000011110000000000000000001D111                  
          11000000100001    10101101   111111111111011010000001                 
            111111 1111      1 1  1                1  1 111111